{
  "levels":[
    {
      "board":[[1,1,1,1,1,1,1,1,1,1,1,1,1,1,1],
               [1,0,0,0,0,0,0,0,0,0,0,0,0,0,1],
               [1,0,0,0,0,0,0,0,0,0,0,0,0,0,1],
               [1,0,0,0,0,0,0,0,0,0,0,0,0,0,1],
               [1,0,0,0,0,0,0,0,0,0,0,0,0,0,1],
               [1,0,0,0,0,0,0,0,0,0,0,0,0,0,1],
               [1,0,0,0,0,0,0,0,0,0,0,0,0,0,1],
               [1,0,0,0,0,0,0,0,0,0,0,0,0,0,1],
               [1,0,0,0,0,0,0,0,0,0,0,0,0,0,1],
               [1,0,0,0,0,0,0,0,0,0,0,0,0,0,1],
               [1,0,0,0,0,0,0,0,0,0,0,0,0,0,1],
               [1,0,0,0,0,0,0,0,0,0,0,0,0,0,1],
               [1,0,0,0,3,0,3,0,0,0,0,0,0,0,1],
               [1,0,0,0,1,2,1,0,0,0,0,0,0,0,1],
               [1,1,1,1,1,1,1,1,1,1,1,1,1,1,1]],
      "back":"bg2.png"
    },{"board":[[1,1,1,1,1,1,1,1,1,1,1,1,1,1,1],
               [1,0,0,0,0,0,0,0,0,0,0,0,0,0,1],
               [1,0,1,1,1,0,0,0,0,0,0,0,0,0,1],
               [1,0,1,0,0,0,0,0,0,0,0,0,0,0,1],
               [1,0,1,1,1,1,0,0,0,0,0,0,0,0,1],
               [1,0,0,0,0,1,0,0,0,0,0,3,0,0,1],
               [1,0,0,0,0,1,0,0,0,3,0,0,0,0,1],
               [1,0,0,0,0,1,0,0,0,0,0,0,0,0,1],
               [1,0,0,0,0,1,0,0,0,0,0,0,0,0,1],
               [1,0,0,0,0,0,0,3,0,1,1,1,1,1,1],
               [1,0,0,0,0,0,0,0,0,0,0,0,0,0,1],
               [1,0,0,0,0,1,0,0,0,1,1,1,1,0,1],
               [1,0,0,0,3,0,3,0,0,0,0,0,1,0,1],
               [1,0,0,0,0,0,0,0,0,0,0,0,1,2,1],
               [1,1,1,1,1,1,1,1,1,1,1,1,1,1,1]],
      "back":"Background.jpg"},{"board":[[1,1,1,1,1,1,1,1,1,1,1,1,1,1,1],
               [1,0,0,0,0,0,0,0,0,0,0,0,0,0,1],
               [1,0,1,1,1,0,0,0,0,0,0,3,1,0,1],
               [1,0,1,0,0,0,0,0,0,0,0,0,1,0,1],
               [1,0,1,0,0,1,0,3,0,0,0,0,1,0,1],
               [1,0,0,0,0,1,0,0,0,0,0,3,1,2,1],
               [1,0,0,0,0,1,0,0,0,3,0,0,1,0,1],
               [1,0,0,0,0,1,0,0,0,0,0,0,1,0,1],
               [1,0,0,0,0,1,0,0,0,0,0,0,1,0,1],
               [1,0,0,0,0,0,0,3,0,0,0,0,1,0,1],
               [1,0,0,0,0,0,0,0,0,0,0,0,0,0,1],
               [1,0,0,0,0,1,0,0,0,1,1,1,1,0,1],
               [1,0,0,0,3,0,3,0,0,1,0,0,1,0,1],
               [1,0,0,0,0,0,0,0,0,1,0,0,1,0,1],
               [1,1,1,1,1,1,1,1,1,1,1,1,1,1,1]],
      "back":"Background.jpg"}

  ]
}
